NO ./maps/pics/north_128.png
SO       ./maps/pics/south_128.png


WE ./maps/pics/blank_wall_128.png

EA                 ./maps/pics/iron_128.png

F ./maps/pics/floor_128.png
E ./maps/pics/turret/turret0.png,./maps/pics/turret/turret1.png,./maps/pics/turret/turret2.png,./maps/pics/turret/turret3.png

C ./maps/pics/ceilling_128.png

 11111111111111111111111111111
100000000000000S000000000000001
1000000000000000000000000000031
1000000000000000000000000000001
1300000000000000000000000000001
1000000000000000000000000000001
1000000000000000000000000000031
1300000000000003000000000000001
1000000000000000000000000000001
1000000000000000000000000000001
1000000000000000000000000000001
1000000000000000000000000000031
1300000000000000000000000000001
1000000000000000000000000000001
1000000000000000000000000000001
1000300030003000300000000000001
 10111111111111111111111111111
 1000000000000001
 1111111111111101
 1000000000000001
 1011111111111111
 1000000000000021
 1111111111111111