NO ./maps/pics/north_128.png
SO       ./maps/pics/south_128.png


WE ./maps/pics/blank_wall_128.png

EA                 ./maps/pics/iron_128.png

F ./maps/pics/floor_128.png
E ./maps/pics/turret/turret0.png,./maps/pics/turret/turret1.png,./maps/pics/turret/turret2.png,./maps/pics/turret/turret3.png

C ./maps/pics/ceilling_128.png

1111111111111111111111111111111111111111
1S00000000000000000000000000000000000001
1011101111101101111101111011111011101111
1000101000000001000000001000000000000001
1010101010101011111101011011110111111131
1010101010110000000101000000000000000101
1000000000001101010101011111011110110101
1010101111010100100000000000011110110001
1010100001010110110111101101000000000101
1000101101010100000000000101011111101101
1010100001000000010101000000000001101101
1000001111101110100101111111101000000001
1010100000000100010101000000000101110101
1010111011010101010101011011101100100101
1000110000010000010101011000000000100101
1010000111110101010100000011110010110101
1010110000010101010101111000110100010101
1010101101010101010100010010100011010101
1010100001000101010101010100101001010101
1010000111101000000100010010001000100101
1010110000101011110101010011111110101101
1000000110101000000001010000000000001101
1010101000101011110111011101111110111101
1010101010100000010100000000001000000001
1010101000101010100011101111011011111101
1000001010101010111010100001000010000101
1010101010100000000010111101011011101101
1010101010101110111010000100000010000001
1010100000001010101011111100110110111101
1000001010101010000000000101000000000001
1011101010101011010101101101010110111101
1003030030000000000001000000000000000021
1111111111111111111111111111111111111111