NO ./maps/pics/north_128.png
SO       ./maps/pics/south_128.png


WE ./maps/pics/blank_wall_128.png

EA                 ./maps/pics/iron_128.png

F ./maps/pics/floor_128.png
E ./maps/pics/turret/turret0.png,./maps/pics/turret/turret1.png,./maps/pics/turret/turret2.png,./maps/pics/turret/turret3.png

C ./maps/pics/ceilling_128.png

111111111111111111111111111111111111111
101010101010101010101010101010101010101
100000000000000000000000000000000000001
101010101010101010101010101010101010101
100000000000000000000000000000000000001
101010101010101010101010101010101010101
100000000000000000000000000000000000001
101010101010101010101010101010101010101
100000000000000000000000000000000000001
101010101010101010101010101010101010101
100000000000000000000000000000000000001
101010101010101010101010101010101010101
100000000000000000000000000000000000001
101010101010101010101010101010101010101
1000000000000000000W0000000000000000001
101010101010101010101010101010101010101
100000000000000000000000000000000000001
101010101010101010101010101010101010101
100000000000000000000000000000000000001
101010101010101010101010101010101010101
100000000000000000000000000000000000001
101010101010101010101010101010101010101
100000000000000000000000000000000000001
101010101010101010101010101010101010101
100000000000000000000000000000000000001
101010101010101010101010101010101010101
100000000000000000000000000000000000001
101010101010101010101010101010101010101
100000000000000000000000000000000000001
101010101010101010101010101010101010101
100000000000000000000000000000000000001
101010101010101010101010101010101010101
100000000000000000000000000000000000001
101010101010101010101010101010101010101
100000000000000000000000000000000000001
101010101010101010101010101010101010101
100000000000000000000000000000000000001
111111111111111111111111111111111111111