NO ./maps/pics/north_128.png
SO       ./maps/pics/south_128.png


WE ./maps/pics/blank_wall_128.png

EA                 ./maps/pics/iron_128.png
F 255,0,0



C 0,255,0

1111111111111111111111111111111111
1E00000000000000000000000000000001
1111111111111111111111111111111111