NO ./maps/pics/colorstone.png
SO       ./maps/pics/greystone.png


WE ./maps/pics/bluestone.png

EA ./maps/pics/purplestone.png
F  255,31,192
C 0,0,255

1111111111111111111111
1000000000100000000001
1000000000000000000001
1000000000000000000001
1100000000000000000001
100000000N000000000001
1100000000000000000001
1000000000000000000001
1000000010101000000001
1111111111111111111111