NO ./maps/pics/colorstone.png
SO       ./maps/pics/greystone.png


WE ./maps/pics/bluestone.png

EA ./maps/pics/purplestone.png
F  ./maps/pics/barrel.png
C ./maps/pics/barrel.png

1111111111111111111111
1000030000100000000001
1000000000000000000001
1000000000000000000001
1100000000000300000001
100030000N000000000001
1100000000000000000031
1000000000000000000001
10000000101010003000001
1111111111111111111111