NO ./maps/pics/colorstone.png
SO       ./maps/pics/bluestone.png


WE ./maps/pics/bluestone.png

EA ./maps/pics/bluestone.png
F 1,0,0




C 0,0,255

1111111111111111111111
1000000000000000000001
1000000000000000000001
1000000000000000000001
1000000000000000000001
100000000N000000000001
1000000000000000000001
1000000000000000000001
1000000000000000000001
1111111111111111111111
