NO ./maps/pics/greystone.png
SO       ./maps/pics/bluestone.png


WE ./maps/pics/bluestone.png

EA ./maps/pics/bluestone.png
F ./maps/pics/barrel.png




C ./maps/pics/barrel.png


1111111
1N00031
1111111