NO ./maps/pics/eagle.png
SO       ./maps/pics/mossy.png


WE ./maps/pics/wood.png

EA ./maps/pics/redbrick.png
F 255,142,118




C 118,148,255

111111111111111111111111111111111111111
10001S10000000000000000000001111 110001
100010100000000000000000000011111111111
100010100000000000000000000011111111111
100010100000000000000000000011111111111
10001010000000000000000000001111111111111111111111111111111111111111
100010100000000000000000000011111111111
100010100000000000000000000011111111111
100010100000000000000000000011111111111
100010100000000000000000000011111111111
100010100000000000000000000011111111111
100010100000000000000000000011111111111
100010100000000000000000000011111111111
100000000000011110000000000011111111111
11111111111111111111111111111