NO ./maps/pics/bluestone.png
SO       ./path_to_the_south_texture


WE ./path_to_the_west_texture

EA ./path_to_the_east_texture
F 1,0,0       




C 255,30,0

1111111111111111111111111
1000000000110000000000001
1011000001110000000000001
10010000000000000000000011111111
111111111011100001110000000000001
100000000011000001110111111111111
11110111111111011100000010001
11110111111111011101010010001
11000000110101011100000010001
10N0000000010011000000100011
10000000000111001101010010001
1100000111011101111101111000111
11110111 1110101 101111010001
11111111 1111111 111111111111