NO ./maps/pics/north_128.png
SO       ./maps/pics/south_128.png


WE ./maps/pics/blank_wall_128.png

EA                 ./maps/pics/iron_128.png

F ./maps/pics/floor_128.png
E ./maps/pics/turret/turret0.png,./maps/pics/turret/turret1.png,./maps/pics/turret/turret2.png,./maps/pics/turret/turret3.png

C ./maps/pics/ceilling_128.png

1111111111111111111111111111111111111111
1S1 100000000000000000000000000000000001
101 101111111111111111111111111111111111
101 101000000000000000000000000000000001
101 101010101011111101011111111111111131
1011101011110000000101000000000000000111
1000000000001101010101011111111111110101
1011101111010100100000000000001111100101
101 100001010110111111111001000000000101
101 101101010100000000000101011111111101
101 100001000000001001000000010000000111
101 101111110100010101011111110000000101
101 100000010100010101000000000101110101
101 111111010100010101011111111100100101
101 110000010000010101011000000000100101
101 110111110100010100000011110010110101
101 110000010100010101111000110100010101
101 1 1101110100010100010010100011010101
101 110001000101110101010100101001010101
101 11011 101000000100010010001000100101
101 11001 101011110101010011111110101101
101 1 1001001010010001010000000000001101
101 1 1100101010000111111111111111111101
101 1   10100000000100000000001000000001
101 111100101001100011101111001011111101
101 100000101100111010100001001010000101
101 100000100101000010111101011011111101
101 1000001011001110100001000000101 1101
101 100000101 10101011111100111111 11001
101 100000101 100010000001010001  100101
101110000011111101 101111101011111111101
100313033010000001 101000000000000000021
1111111111111111111111111111111111111111